W	W	W	W	W	W	W
W	A	F	F	F	F	W
W	F	F	F	F	F	W
W	F	F	P	F	F	W
W	F	F	F	F	F	W
W	F	F	F	F	F	W
W	W	W	W	W	W	W